############################
#                          #
#  B       C              D#
#                          #
#                          #
#       T       J          #
#                          #
#                          #
#    P       M             #
#                          #
############################
